F 43,43,43
C 115,115,255

NO ./texture/greystone.xpm
NO ./texture/greystone.xpm
SO ./texture/redbrick.xpm
EA ./texture/colorstone.xpm
WE ./texture/purplestone.xpm









        1111111111111111111111111
        1000000000110000000000001
        1011000001110000000000001
        1W01000000000000001000001
111111111011000001110000000000001
100000000011000001110111111111111
11110111111111011100000010001
11110111111111011101010010001
11000000110101011100000010001
10000000000000001100000010001
10000000000000001101010010001
11000001110101011111011110101
1111011111110101110111101001
11111111 1111111 11111111111
