C 255,20 ,30
R 1920 1080
NO ./textures/eagle.xpm
SO ./textures/greystone.xpm
EA ./textures/red.xpm
WE ./textures/purplestone.xpm
C 255,20 ,30

S ./textures/tonneau.xpm
F 1, 1, 100



11111111111111111111111111
10000000000000000000000001
10000000000000000000000001
10000000000000000000000001
10000000000000000000000001
10000000000000000000000001
10000000000000000000000001
10000000000000000000000001
10000000000000000000000001
10000000000000000000000001
10000000000000000000000001
10000000000000000000000001
10000000000001000000000001
10000000000000000000000001
10000000000000000000000001
10000000000000000000000001
1000000000000N000000000001
10000000000000000000000001
11111111111111111111111111
